NO texture/wolf/redbrick.xpm
SO texture/wolf/colorstone.xpm
WE texture/wolf/mossy.xpm
EA texture/wolf/greystone.xpm

F 225,30,0
C 225,30,0

11111
11111
11111
11111