NO texture/wolf/redbrick.xpm
SO texture/wolf/colorstone.xpm
WE texture/wolf/mossy.xpm
EA texture/wolf/greystone.xpm

F 212, 197, 146
C 105,102,103

        1111111111111111111111111
        1N00000000110000000000001
        1011000001110000000000001
        100100000000000000W000001
11111111101100000111000000000N001
100000000011000001110111111111111
11110111111111011100000010001
11110111111111011101010010001
11000000110101011100000010001
10000000000000001100000010001
1000000W0000000011010100S0001
1100000111010101111101111000111
11110111 1110101 101111010001
11111111 1111111 111111111111
