NO texture/wolf/redbrick.xpm
SO texture/wolf/colorstone.xpm
WE texture/wolf/mossy.xpm
EA texture/wolf/greystone.xpm

F 229,217,190
C 203,229,190

11111
100N1
10001
1S001
11111
