NO texture/backroom/wall0.xpm
SO texture/backroom/wall1.xpm
WE texture/backroom/wall2.xpm
EA texture/backroom/wall3.xpm

F 212, 197, 146
C 105,102,103

        N111111111111111111111111
        1000000000110000000000001
        1011000001110000000000001
        1001000000000000000000001
111111111011000001110000000000001
100000000011000001110111111111111
11110111111111011100000010001
11110111111111011101010010001
11000000110101011100000010001
10000000000000001100000010001
10000000000000001101010000001
1100000111010101111101111000111
11110111 1110101 101111010001
11111111 1111111 111111111111
