NO ./asset/texture/wolf/redbrick.xpm
SO ./asset/texture/wolf/colorstone.xpm
WE ./asset/texture/wolf/mossy.xpm
EA ./asset/texture/wolf/greystone.xpm

F 220,100,0
C 225,30,0

111111111111111111111111111111111
100000010000000000000000000000001
100000010000000000000000000000001
100000010000000010000000000000001
100000010000000111000000000000001
100000000000000010000000000000001
100000000000000010000000000000001
100000000000000000000000000000001
1000000000000000N0000000000000001
100000000000000000000000000000001
100000000000000000000000000000001
100000000000000000000000000000001
100000000000000000000000000000001
100000000000000000000000000000001
111111111111111111111111111111111
