NO texture/backroom/wall0.xpm
SO texture/backroom/wall1.xpm
WE texture/backroom/wall2.xpm
EA texture/backroom/wall3.xpm

F 212, 197, 146
C 105,102,103

        1111111111111111111111111
        1000000000110T00000000001
        101100T0011100000000T0001
        1001000000D0000000W000D01
111111111T1100000111000T000000001
100000000011000001110111111111111
11110111111111011100000010001
1111D1111111110111D1010010001
11000000110101011100000010001
10000T00D00000001100000010001
10000000D00000001101010000001
1100000111010101111101111000111
11110111 1110101 101111010001
11111111 1111111 111111111111
