NO texture/wolf/redbrick.xpm
SO texture/wolf/colorstone.xpm
WE texture/wolf/mossy.xpm
EA texture/wolf/greystone.xpm

F 229,217,190
C 203,229,190

111111111111111111111111111111111
100000010000000000000000000000001
100000010000000000000000000000001
100000010000000010000000000000001
100000010000000111000000000000001
100000000000000010000000000000001
100000000000000010000000000000001
100000000000000000000000000000001
1000000000000000S0000000000000001
100000000000000000000000000000001
100000000000000010000000000000001
100000000000000000000000000000001
101000100000000000000000000000001
101000100000000000000000000000001
111111111111111111111111111111111
