NO texture/wolf/redbrick.xpm
SO texture/wolf/colorstone.xpm
WE texture/wolf/mossy copy.xpm
EA texture/wolf/greystone.xpm

F 229,217,190
C 203,229,190

11111
10001
10N01
10001
11111
